11111
10P01
10001
1C0C1
100E1
11111